11111111111
1000C000001
10111111100
1P0000000E1
11111111111