11111111111
1000C000001
10111111101
1P0002000E1
11111111111