11111111111111111111111111111111111111111
1000C000000000000000000000000000000000001
10111111100000000000000000000000000000001
1000000000000000000E000000000000000000001
10000000000000000000000000000000000000001
1000000000M000000000P00000000000000000001
10000000000000000000000000000000000000001
10000000000000000000000000000000000000001
10000000000000000000000000000000000000001
11111111111111111111111111111111111111111