111111111111111111111
1000C0000000000000001
101111111000000000001
1P00000000000000000E1
100000000000000000001
1000000000M0000000001
100000000000000000001
1000000000M0000000001
100000000000000000001
100000000000000000001
100000000000000000001
111111111111111111111