1111111111111111111
1000C00000000000001
1011111110000000001
1P000000000000000E1
1000000000000000001
1000000000M00000001
1000000000000000001
1000000000M00000001
1000000000000000001
1000000000000000001
1000000000000000001
1000000000000000001
1000000000000000001
1000000000000000001
1000000000000000001
1000000000000000001
1000000000000000001
1000000000000000001
1000000000000000001
1000000000000000001
1000000000000000001
1000000000000000001
1000000000000000001
1000000000000000001
1111111111111111111