11111111111
10000000001
10111111101
1P000000E01
11111111111