11111111111
1000C000001
10111111101
1P000000001
1000000E001
10000000001
11111111111