11111111111
1000C000M01
1M111111101
1P0000000E1
11111111111