11111111111
1000C000001
1C1111111C1
1P000C000E1
11111111111