11111111111
1000C00P001
10111111101
1P0000000E1
11111111111