11111111111
10000000001
10111111101
1P0000000E1
11111111111