11111111111
1000C000001
10111111101
100000000E1
11111111111