11111111111
1000C000001
10111111111
1P0000100E1
11111111111