11111111111
1000C00001
10111111101
1P000000E01
11111111111